stand branch	black white branch
green white train track	green white train track
small white stand underneath chair	white stand floor
water marina	
drive street	doubl decker drive street
camera	small stand water
passeng train station	passeng train station
woman dinner write notebook	woman someth
comput floor	macintosh comput floor
close-up brown horse'	horse'
group peopl outsid	group elderli peopl around
curiou	small woodi
jockey	jockey
stand field	brown stand green field
motorcycl	motorcycl
woman brown	young brown
black white front	black brown stand plain front uproot
	black white blanket
front	front
sleep	asleep chair
group peopl dinner	peopl dessert around
black stand front yellow flower	black stand field
close bottl water	close bottl water
close brown	close ostrich
sheep stand afield	sheep graze field
group peopl outsid	group elderli peopl around
longed-hair close	close close
woman shirt smile camera while woman behind	woman surpris smile woman behind
silver amtrak train track small train station	small white station
person shirt reclin coffe televis	person stand motorcycl wheeli
window	white window
black white photo woman	black white photo stall
brown stand field	brown stand green field
pitch background	black white background
older beret mountain background	sheep background
trough	brown white trough
small perch amongst branch	brown perch branch
person helmet white structur	black short stand motorcycl
group peopl around	group peopl around
black color small apart	black brown
brown stand green field	brown green field
black white	black white
elderli woman stand kitchen	stand kitchen
school drive uphil rural	drive along
cotton front couch	calico front
camouflag airplan grassi field	camouflag plane green grass
three young women stand togeth	indian women indian water
doubl decker drive through street	doubl decker passeng drive traffic
white sheep hillsid camera	skinni stand grass
group sheep field	group graze field
close-up distort photo empti glass bottl	close-up pictur comput paper
crowd offic comput monitor	messi comput monitor
clutter	clutter
white green pastur	pastur
bicycl coffe	bicycl patio coffe
black under pastur	under pastur
stand field background	black white water grass background
peopl restaur	peopl
doubl decker drive street	stori drive along street
smile woman outsid anoth smile woman	women outsid laugh
metal	multi-color cling
skinni stand grass	white stand ground
women across	women smile camera while
woman necklac	young woman black necklac
brown stand field	brown stand middl grassi field
cruis liner shorelin	cruis shore
black white under	black white yellow loung
brown white stand grass	brown white stand grassi behind
small camera while stand grass	women smile camera while stand kitchen
yellow camera	glass plastic bottl foreground
black white photo couch	black white photo under
camera	camera
doubl decker crowd street	doubl decker street
jockey	jockey gallop
float water	green float waterl
chevrolet sport	chevrolet concept
person helmet white structur	person helmet through
black white photo train station	black white photo motorcycl ground
white tabbi sleep purpl fabric	black white sleep brown
black white branch	black white right
woman small	smile woman small
group graze grassi field	group graze field
three drink	three
peopl dress white stand grass field	person stand underneath overpass highway
young blond helmet bicycl behind	young helmet bicycl background
orang tabbi sleep	watch
perch branch	perch branch
stripe litter	domest litter
couch	couch shine
small child camera	woman camera
offic three comput monitor equip	sever comput monitor
stand	sever cardin stand
udder dairi stand pastur build	black brown stand green grass
black vehicl low-li mountain	black countri
passeng train	passeng train station
black ground	blackbird ground
black white camera	black white camera
woman pillar	woman stand pillar where written
young white	young blond white
black white sheep white sheep	littl black white
background	wheeli plank beach background
afternoon	wooden playmat
sidewalk front graffiti	scooter street front build
seagul float water	littl float water
flock sheep spread field	white stand floor
couch	couch
black stand materi construct	asian toddler flower marbl
woman front apart build	woman stand front build
asian occas woman glass smile thumb	women camera thumb
black train track	mostli black train track
graze besid	sever sheep graze field
mountain graze front alpin	graze mountain water
black white behind	black white behind metal against partli cloudi
passeng train station	passeng train train station
white through cover	white through cover
bicycl	bicycl outsid bookstor
grass toward	train track
black screen televis place floor	screen floor
silver bicycl	bicycl
orang white blanket black leather chair	ginger white asleep leather chair
brown white pillow	couch white pillow
black train train track	train train track
black train train track	train train track
young coupl black couch	young coupl couch
group black peopl front build	group peopl outsid decrepit build
orang tabbi sleep	green couch
elderli woman pattern couch around younger woman	women couch camera
perch	perch branch
coupl pictur couch	young coupl couch
guitar drink	young jacket sheep
togeth window	window
doubl decker	doubl decker
close-up stand grass	close-up woman black motorcycl
brown white floral-pattern chair	small orang white collar relax flower print pillow
black brown camera	black white camera
orang	african yellow
group peopl restaur	group peopl around
sheep cliff camera	sheep stand camera opposit direct
black white photo empti train station	black white photo
locomot field	brown stand field
white comput carpet bedroom	comput floor
under small	sleep under
white drive	drive
water	water
sport track	sport drive quickli track
smile woman small	smile women
black concret	small white
victori liner white stripe	white orang yellow stripe
doubl decker street	doubl decker street
group river background	young helmet bicycl background
seagul float water	cruis float water
motorcycl	motorcycl between
cushion camera	moggi camera
window	window
black white photo under	black white photo under field
plant sunlight window	plant sprout
green white train track	green white train train track
peopl shore	peopl green water
shirt brown	white yellow coverlet
airplan	plane
train travel track	train track
small chair front laundri	washer dryer
amtrak passeng train station	passeng train station
ground airport	passeng through
camera	black white camera
world headlin display screen	dress relax
women	smile women
young helmet	blous brown
wooden	
peopl porch	peopl acouch
stand	group graze field
guitar	orang
train yellow train track	train travel track
peopl restaur	group peopl around porch
stand	sheep stand children
father chair	shirt sleep chair infant
close ostrich	close ostrich
person outdoor	person motorbik
grassi field	sheep stand green
green white perch branch	green white chest perch branch
water	float water
white plane sunni	white plane through
white	white
black white photo train station	black white photo
bicycl front	bicycl front build
woman	smile woman
white doubl decker	white doubl decker
doubl decker street	doubl decker crowd street
woman brown	woman photo
field black sheep	black sheep
perch metal	small perch metal
drive	green drive
cloth kitchen	wooden cabinet kitchen
elderli asian coupl dinner	older asian coupl newborn dinner
brown white green grass	white plane sunni
young woman bracelet bikini	women bikini
brown graze field green grass	brown stand middl grassi field
liquid center tinfoil cover plate	place center tablecloth
black white stand grassi field	stand grassi field
yellow airplan	white airplan
stand grass stare	woman
women chair christma	train track train
asian young peopl	chair
train track	train glide track
young woman dress black	young dress chair
indian women indian water	indian woman stand indian beach
group peopl drink	peopl
peopl	wooden candl purpl plastic
plane distanc	woman white
group river background	group field yellow
background	background
yellow stripe	orang tabbi sleep
passeng train station	through
peopl paddl background	peopl yellow river background
front	white grass front build
peopl urban	peopl
black train track	black train track
white front store	white street
women stand front	front plane
person drive bicycl	three wheel bicycl
silver locomot engin	silver train station
black motorbik	child black leather chair
bicycl outsid bookstor	peopl stand outsid bookstor
plane mid-flight sunset	plane sunset
peopl motorcycl	branch
garden front	white build besid formal garden
yellow parrot cling	yellow orang
bottom	black white close
coupl small sailboat	small sailboat
silver motorcycl	motorcycl
doubl decker	double-deck
stand pretti build background	polic offic stand behind background
small white while wooden	white wooden floor underneath
stand front silver train	stand front silver
close-up sheep tongu	close sheep tongu
black white stand field	black white stand field
small branch winter	small perch branch
yellow fruit grate	yellow fruit feeder
white arena	white
brown white stand grass	brown white green grass
black white stripe couch	black white stand front window
train track field	train travel track
women small child dinner smile camera	small wooden camera
buddha statu wooden runner	stand wooden fencepost
black formal black white	white
drive front garden	train station
graze cover field	graze cover field
white	woman brown
small brown feeder	small perch feeder
pictur countrysid background	black cattl grassi plain background
shirt stand front fountain	shirt stand front statu cobbl stone plaza
brown	shirt brown
scantili woman stand	yellow orang
sever televis floor stack anoth	three televis floor
sheep graze grassi field stand	sheep graze field front
clear plastic chair front bookcas	clear plastic chair front shelv
jacket	jacket
sheep stand hillsid	sheep stand
black white stand grassi field	black white stand field
plane mid-air flight	airplan while flight
woman black bikini	woman black stand subway
brown	jockey purpl brown
stand front yellow corvett	stand yellow sport
three	three kitchen
grass toward	stand sidewalk front
front fountain statu	shirt stand front fountain
small protect owner	adorn sticker
children sheep	child outsid
white stand carpet	sheep stand forest
screen floor	flat-screen floor
close-up green	close-up cream
brown stand grassi field	small sailboat
sheep stand doorway	stand snowi ground
train train station	train train station
sever comput monitor	comput monitor
outsid bookstor street	yellow motorcycl street
train track along	floor patio
passeng runway	passeng close ground
littl laugh camera	white camera
green bottl	three
three young women stand togeth	three young women white black sweater
black-and-whit photo loveseat	black white photo train station
sticker	sticker
white stare	stand
screen televis	furnitur screen televis
black white front	white airplan
black white stand grassi field	black white stand field
women chair	women
doubli decker drive	doubl decker drive street
black white photo	black white
woman stand smile camera	woman camera
orang white asleep leather chair	ginger offic chair
white stand carpet	pretti white stripe
white domest kitten	bicycl green grass
white orang stand	white orang stand shorelin
woman front apart build	white grass front build
young woman bracelet bikini	woman bikini bracelet
train drive through cover	train track
chair pictur	school drive green grass background
black ground	under background
cross watch small	close small televis
cargo plane runway	passeng plane runway
headlight	close headlight
sleep purpl sheet	black white sleep purpl blanket
passeng train station	passeng train station
close-up cream	close-up
three bicyclist cross bridg	bicyclist cross bridg
white drive england street	white england drive street
airplan camera	
woman brown	person dress white brown
jockey	jockey
blend stuff	couch
kitchen cabinet	kitchen wooden cabinet furnitur
train track	train track rural
motorcycl cover graffiti scene cityscap	motorcycl mural
someon stand snowi mountain watch plane	stand mountain watch plane
water	water
water	black water
black camera	black white camera
cruis liner	cruis coast
doubl decker crowd street	white partial public street
woman	woman
black white blanket	black white basket
mountain inclin	mountain clear
reclin offic chair	ginger offic chair
group graze field	brown graze field green grass
group peopl drink	locomot field
kennel ahead	woman
three sheep passeng vehicl	three sheep middl gravel
yellow airplan	white aircraft format trail smoke
train train station	train station
train track field	grass
doubl decker passeng	doubl decker passeng
couch	women watch street cross
women kitchen object	women kitchen pictur
gallop without rider	gallop while number
steam engin train toward camera	toward camera
group graze field	group graze grassi field
black white photo glass bottl	black white pictur short squat coca-cola bottl
small perch branch	yellow perch branch
sever peopl motorcycl market squar	peopl motorbik street
three sheep passeng vehicl	three sheep
glass comput	comput screen
group peopl dress	group peopl stand peopl dress
truck while black frame	truck smoke behind
chair alongsid	wooden bench dresser
smile woman small	woman
station background	polic offic stand behind background
yellow plane	yellow plane flight
stand anoth background	group river background
three bottl	green bottl
anoth point	peopl point
steam engin train track	train train station
train train station	train train station
white water	water
parrot small	white steer
woman	
yellow paddl through water	paddl yellow toward shore
toward water feeder	feeder
stand field	stand field
bottl -lrb- lager -rrb- floor	bottl floor
women outsid laugh	women stand outsid
group sheep graze	group sheep
stand front train	stand front statu
steam engin train toward camera	white sheep hillsid camera
women camera thumb	smile young women thumb
women small while	woman
doubl decker street	doubli decker drive
women brown couch	women stand outsid
green camera	black white camera
branch	sheep stand under
group peopl restaur	peopl restaur
black white stand grass against partli cloudi	black white behind metal against partli cloudi
brown white field camera	black white camera
white	white arena
dairi drink	drink
sever shear sheep	three white sheep enclosur
black white stand	black white stand field
black grass	black grass
offic space bright green artwork	offic multipl green
white cruis float water	cruis float water
young peopl slide glass person point	peopl point
black white photo drive someon motorcycl	black white photo classic classic motorcycl
woman along beach	beard skullcap along ocean' shore
sheep camera	camera
black white camera	small black white camera
black white fuzzi chair	woman child
doubl decker passeng	doubl decker drive street
water	sailboat cloudi
perch glove person	perch person' glove
three peopl water yellow	three peopl prepar
brown white	brown
mostli black train track	front train track
young color crayon	young blond white
perch branch	perch branch
backpack stand besid train	social gather peopl restaur
group peopl	group peopl giant mushroom
mallard white grass water	small child dress
between bicycl front	stand field front
stand street	black stare sheep
	
rider white	woman white
dress scarf stick	runner shade bottl
branch	brown perch branch
train train track	train train track
black black sheep	black brown sheep
sever comput pictur	offic three comput monitor equip
retro televis	wooden
black white photo under field	black white camera
silver areomexico liner tarmac	aeromexico silver plane runway
	motorbik behind
	brown
peopl small white	coupl small sailboat
white airplan cement	motorcycl sidewalk
group peopl	group cyclist green white spectat
three graze field	sever sheep graze field
street	silver front
messi laptop	laptop comput messi
black domest brown	
candl teapot	wooden candl purpl plastic
children	children sheep
black white basket	black white blanket
peopl paddl reflect still water	peopl clear
scantili woman stand	scantili woman stand small vehicl
doubl decker passeng	doubl decker
cross cloak stick	cross while brown cloth wooden stick
buddha statu candl	small while
black white bottom stair	bottom staircas anoth stand
three peopl dinner smile camera	elderli women dinner
multi-color train track	mostli black train track
white travel street	street
plane	fighter plane
small creek	river
women restaur	group peopl italian restaur
fashion wooden ocean	fashion wooden
stand field	small white
cross grass background	ocean liner close coast background
black white photo window chair	black white scene furnish outlook forest
close brown halter	close halter
black water	water
close-up cream	siames white
person bicycl perform trick	person outdoor
yellow school rural	yellow school field
yellow chair green dumpster	bulldog yellow chair besid receptacl
woman motorcycl	white sheep stand green
sheep stand auction	woolli sheep auction
close-up black train engin	close white sheep black
orang white asleep leather chair	orang white blanket black leather chair
train track	train track between
float water	wooden yacht ocean
black white stand grassi field	black white stand field
doubl decker street	doubl decker drive street
couch window	window
televis hotel light	televis laptop comput hotel
small bicycl	wheeli
three round	three chase
woman dress white	person helmet bicycl sunni
wheeli mountain	woman pillar
puppi carpet floor	puppi white carpet
black train track	train travel track
close-up pictur white purpl motorcycl	close-up pictur comput paper
young brown	woman brown
black stand grassi	long-hair stand grassi
women kitchen object	three
women	woman
group peopl around contain	peopl around withsnack
train station	train station
motorcycl sidewalk	sidewalk
stand	stand green grass
doubl decker street	doubl decker drive street
train insid train station	train train station
woman equestrian	woman brown
empti offic cubicl	empti offic chair cubicl
white	woman white
train track	black steam train travel railroad track
women smile camera while	women smile camera while stand kitchen
woman restaur	women restaur
young stripe shirt bicycl	young redhead bicycl beach
cruis harbor behind	cruis coast
white plane runway	white swiss airplan approach runway
cross intersect	cross street
sever graze median	graze patch grass between roadway
televis upholst chair coffe stabl bright	leather couch wooden
white stand ground	woman black stand subway
black brown stand plain front uproot	black brown stand front small field
doubl decker drive street	doubl decker street
group peopl outsid	group peopl restaur
grassi field	person grassi field sheep
close front purpl white motor	close sport
women cloth store	women cloth store
group peopl restaur	group peopl restaur
close-up brown horse'	close-up yellow school
person stand brick support	brown stand grass scrub
mother grassi field	close-up young larger
women stand brown	women glass stand field
couch window	window
truck	
woman shift dress	woman dress
black white camera	black white camera
brunett yellow motorcycl	coupl yellow motorcycl
small white stand	white bathroom
tandem bicycl	tandem bicycl
small sweater camera	small white jacket camera
stand grass stare	women chair
comput	comput
small child smile camera	small child cement white flower
littl float water	float water
woman stand front build	women front
white julia water	white water background
offic space bright green artwork	small offic space bright green
white train track	train mountain
young	woman smile
green saloon	green outsid saloon
yellow beach	yellow shore
group peopl around restaur	group peopl restaur
kitchendin paper cloth	small kitchen clutter cloth
train station	train insid indoor station
window camera	stand window camera
stand water	water
black white	black white behind
guitar while	white drive
woman camera	camera
doubl decker drive street	doubl decker street
green white cargo plane airport	white green commerci airlin runway
three graze grassi field	three graze field
brown train railroad track	white train track
black white stand field	black white photo
close togeth insid black white furri enclosur	kitten insid cow-schem fur-cov
blond child dress mother	young blond helmet bicycl behind
group peopl restaur	group peopl around porch
black white	black white
double-deck	front doubl decker
yellow school field	brown green field
close-up horse'	horse'
elderli laptop	older gentleman couch laptop
fashion wooden ocean	wooden yacht ocean
sheep stand mountain	sheep stand
group peopl small kitchen	group peopl stand small child
white plane runway	white airplan runway
puppi	puppi
	branch
furnitur	wooden furnitur
women across	short
motorbik track	biker
	through
black white camera	black white camera
wooden	scrap
green camera	green camera
stand grassi	biker
black white photo bottl front	bottl water stone stone background
woman brown	brown
black white photo	black white photo under
black white brown chair	black white chair
black white stand field	black white field
white bottl woman turtleneck white	woman field bottl
	black white stand field
doubl decker drive street	doubl decker drive street
black white windowsil	small white
sheep	sheep
black stand materi construct	black stand middl construct
black desktop flake carton	black short stand motorcycl
close small cactu	close woman white puppi
white sheep stand green	sheep stand hillsid
long-hair stand between half-empti bottl	jacket between bottl
black white water grass background	ferri wheel background
wooden bicycl	group elderli peopl around
black white photo dilapid wooden	black white photo wooden dirti street
women chair	women
brown stand green meadow	brown stand grass
helmet	stand bicycl outsid
aeromexico along runway	silver areomexico liner tarmac
	stand
women paint chair background	along beach background
video store	store
group peopl around porch	group peopl around
older asian coupl newborn dinner	group elderli peopl around
young helmet bicycl background	women small leash chair background
sticker	adorn sticker
bicycl outsid bookstor	green outsid store
brown doubl decker street ferri wheel behind	double-deck drive front ferri wheel
black white chair front brick window bamboo plant	black sheep cover thick white stand pastur sheep
domest window	white window
graze field	brown green field
black uniform white	white
sleep coach pillow behind	print blanket
women stand black	women stand black toward camera
motorbik cours	motorbik track
peopl paddl reflect still water	peopl paddl background
close-up headlight old-fashion	close headlight
person stand underneath overpass highway	person along water'
drive model build	vehicl drive infant ornat build
woman child stroller sidewalk	women young pushchair along sidewalk
orang airplan	plane
young woman riding-r	stare white
white	white sheet
black white blanket	black white sleep purpl blanket
build temporari entranc	light
group peopl around contain	group peopl around porch
women small	woman
black white blanket	black white sleep purpl blanket
black white photo	black white photo bicycl
background	background
woman lemon	women restaur
train through tunnel	train travel through tunnel amongst
doubl decker	london doubl decker
laptop comput comput monitor	laptop workstat
white	woman white
background	background
orang kitten leather couch	young coupl black couch
white offic chair	white sheet
small yellow tropic beach	small stone white flower plant
women sheer white sheep insid wooden build	women shear white sheep wooden stall
person helmet phone	person helmet white structur
subway train station	white train station
bicycl	green outsid store
stand beach	women stand front
glass plastic bottl foreground	water bottl front
long-hair black stand grassi field	stand grassi field
small chair laundri closet	washer dryer
doubl decker drive through street	doubl decker drive street
water	black water
brown	wooden
motorcycl outsid	motorcycl
close-up brown	close-up
couch	couch puppi
black white	black white pictur
ground airport	airplan airport night
wooden build materi chair	wooden debri chair
women	catch swamp
eight bottl lager floor	eight bottl wooden floor
offic multipl green	small offic space bright green
woman white	white
small child smile camera	camera
woman brown	person dress brown
photo televis screen	wall-mount flat-screen
perch flowerpot	perch flowerpot besid stucco
white insid	white bathroom
young woman	young
peopl small	women sailboat
small branch	small perch branch
	branch
couch window	couch window photo
motorcycl perform wheeli	motorcyclist perform wheeli
passeng train train station	passeng train yellow engin
young women shear sheep	women sheer sheep
silver train engin	close-up black train engin
young rider brown	young femal rider brown
peopl restaur camera	group peopl restaur
littl white	white against wooden
black train track	train train track
philip flat-screen shown remot control	phillip screen remot control
cruis front	calico front
young white	littl white
black stand materi construct	black stand construct
couch	leather couch wooden
water	black water
black white stand camera	black white sheep stand grass
black white blanket	black white
young woman	woman brown
plane readi take-off	small turboprop plane tarmac
white leather couch throw blanket	televis
peopl river	peopl water
brown stand field	brown green field
kitchen wooden cabinet furnitur	kitchen wooden cabinet
white bicycl stand floor	style bicycl floor
feeder	yellow fruit feeder
black concret	black stand concret
front plane	front small plane
color stand grassi field	stand grassi field
young blond smile bicycl helmet	young helmet bicycl background
brown white blanket	ginger white
attack broom	white bathroom
train train station	train train station
coupl	coupl newborn
small feeder	feeder
close white sheep black	close-up sheep black
brown stand grassi field	brown stand middl grassi field
young	small
perch	small perch
street	yellow scooter alley
black white camera	black white camera
	brown train railroad track
train railroad track	train train track
couch small white	small
silver locomot engin	close-up silver train engin stripe
women drink basketbal pictur background	woman drink someth while
green steam engin travel railroad track	black steam train travel railroad track
small truck	sport white truck
photo front train	stand platform front silver train
bicyclist black black	cyclist black white speed spectat
kitchen countertop shelv	small kitchen stack shelv counter
woman floor	floor
black white through	black white camera
televis messi sever bookcas	televis stereo bookshelf
black white sleep purpl blanket	black white ground
woman bicycl concret	women mountain concret
stand field	graze field
touch black	beard black white
stand yellow sport	stand yellow corvett
	
women cloth store	women sailboat
woman white	woman white
black white photo stall	black white photo cattl trough
older gentleman motorcycl	motorcycl
depress woman couch	older woman newborn
doubl decker london ferri wheel background	brown doubl decker street ferri wheel behind
yellow black feeder	flock water
black white graze	black white drink
small camouflag airplan grass	small shirt
stand front train	stand platform front silver train
small plane airfield cloudi overhead	small white plane airport cloudi
water small plane	water small airplan
white arena	domest stand
macintosh comput floor	comput floor
elderli woman catch bicycl	water locat front mountain
black white brown chair	yellow chair green dumpster
sheep stand afield	stand sheep field
group elderli peopl around	group elderli peopl around
black white photo	black white photo couch
three women brown smile	three women indian dress crowd smile
black white photo empti train station	black white photo
brown white trough	brown white trough
kennel ahead	
black stand concret	stand green grass
black white through	black white ground
sever peopl motorcycl market squar	peopl urban
close-up sheep grass	close-up stand grass
domest litter	domest under black
crowd peopl giant mushroom	group peopl giant mushroom
green toward wooden telephon	green telephon
person motorcycl while stand	stand helmet motorcycl empti
three graze field	graze field
young woman outstretch stand front place	stand front
sheep besid	sheep mountain background
black white stand grassi field	black white photo stand
perch glove	perch person' glove
group peopl outsid	group peopl outsid
ketchup packet	highchair ketchup packet
close-up horse'	close-up brown horse'
togeth window	couch window
train train station	train station
brown stand field	stand field
bench leash sidewalk	women small while
small wooden camera	small sweater camera
black ground	branch
group peopl italian restaur	group peopl salad
close camera	white bathroom camera
scooter sidewalk	sidewalk
older woman newborn	woman
small brown feeder	small perch
